90 90
                                         $                                                
                                         $                                                
                                        $$                                                
                                        $                                                 
                                        $                                                 
                                        $                                                 
                                        $                                               $$
                                        $                                             $$$ 
                                        $                                            $$   
                                        $                                          $$$    
                                        $                                        $$$      
                                        $                                      $$$        
                                        $                                    $$$          
                                        $                                  $$$            
                                       $$$                               $$$              
$$$                        $$$        $$ $$                             $$                
  $$                      $$ $$     $$$   $                            $$                 
   $$$                    $   $$   $$     $$  $$$$$                   $$                  
     $$$                  $    $$$$$       $$$$   $$$$$$$$            $                   
       $$$               $$      $$         $            $           $$                   
         $$              $                 $$            $$         $$                    
          $$$$$         $$                 $              $        $$                     
              $$$$$$   $$                  $              $       $$                      
                   $$$$$                   $$             $$     $$                       
                     $$$                    $              $$    $$                       
                      $                     $              $$    $                        
                      $$                    $               $$  $$                        
                       $                   $$               $$ $$                         
                       $                   $                $$$$                          
                       $$$$                $               $$  $$                         
                      $$  $$$ $$$          $$             $$    $$$                       
                     $$     $$$ $$          $            $$       $$$                     
                    $$           $$         $           $$          $$$                   
                $$$$$             $$        $          $$             $$$$                
             $$$$                  $$       $          $                 $$           $$$$
$$$$$$$$$$$$$$                      $$      $         $$                  $$      $$$$$   
                                     $$ $$$$$$ $$$$$$$$                    $$$$$$$$       
                                      $$$    $$$     $                                    
                                      $              $$                                   
                                      $               $                                   
                                      $               $                                   
                                     $$               $                                   
                                     $$               $                                   
                            $$$      $$               $                                   
               $$$$$       $$ $$$$$  $$               $       $$$$$$                      
            $$$$   $$     $$      $$$$$              $$$$    $$    $$$$$                  
         $$$$       $    $$         $$$$             $  $$$$$$         $$$$               
  $$$$$$$$          $$  $$             $$            $      $             $$              
$$$                  $ $$               $$$$         $                     $$             
                     $$$$              $$  $$        $                      $$$$$$$$$     
                    $$$               $$    $$       $                      $       $$$$$$
                  $$$                 $      $       $                     $$             
                 $$                  $$      $$$    $$                    $$              
                $$                  $$       $ $$$$$$$                   $$               
                 $                  $        $     $$$                   $                
                 $                 $$        $      $$                   $                
                 $                $$         $       $                   $                
                 $$               $         $$       $$                  $                
                  $$             $$         $$        $                  $                
                   $            $$          $$        $$$$               $                
                   $            $           $            $              $$                
                  $$            $           $$           $$             $                 
                  $$           $$            $            $$            $                 
                   $$          $             $$            $$$$        $$                 
                    $$        $$              $$              $$       $                  
                     $$$     $$                $$              $$     $$                  
                       $$    $                  $               $$   $$                   
                        $ $$$$$                 $                $   $                    
                       $$$$   $$                $                $$$$$                    
                     $$$       $$$$             $               $$   $                    
                   $$$            $$$$          $              $$    $$                   
                  $$                 $$         $         $$$$$$      $                   
                 $$                   $$$     $$$      $$$$           $$                  
               $$$                      $$$$$$$ $    $$$               $$                 
              $$                                $$  $$                  $$                
            $$$                                  $$$$                    $$               
           $$                                    $$                       $$              
         $$$                                     $                         $$             
       $$$                                       $$                         $$            
     $$$                                          $                          $$           
   $$$                                            $                           $$          
 $$$                                              $                            $$         
$$                                                $$                            $$        
                                                  $$                             $$$      
                                                  $$                               $$     
                                                   $                                $$    
                                                   $$                                $$   
                                                   $$                                 $$$ 
                                                   $$                                   $$
                                                   $$                                    $
