90 90
                              $                  $                                        
                              $                 $$                                        
                              $                 $                                         
                              $$                $                                         
                               $                $                                         
                               $                $                                         
                               $                $                                         
                               $                $                                         
                               $                $                                         
                              $$                $                                         
                              $                 $                                         
                             $$                 $                                         
                             $                  $                                         
                            $$                  $                                         
                            $                   $                                         
                            $                   $                                         
                           $$                   $$$$                                      
                          $$$                   $  $$$$$$$$                               
                          $                    $$         $$$$$                           
                          $                    $              $$                          
                          $                    $               $                          
                          $$                  $$               $                          
                           $                  $                $$                         
                           $                  $               $$                          
                           $                 $$               $                           
                           $                $$               $$                           
                           $                $               $$                            
                          $$                $               $$    $$$$$$$                 
                         $$$                $               $$  $$$     $                 
                        $$                $$$$               $$$$      $$                 
                       $$                $$  $$               $$       $                  
                      $$                 $    $                        $                  
                     $$                 $$    $$                       $                  
                     $                 $$      $                       $                  
                     $                $$       $$                      $                  
                     $               $$         $                      $                  
                    $$              $$          $$                    $$                  
                    $$         $$$$$$            $                    $$                  
                    $$     $$$$$                 $$                   $$                  
                    $$   $$$                      $                  $$                   
                    $$$$$$                        $$                 $$                   
                    $$$                            $$$               $$                   
                    $                                $$$            $$$                   
                   $$                                  $$$          $$            $$$$$$$$
          $$$$$ $$$$$                                    $$$ $$$$$$$$$$    $$$$$$$$       
$$$$$$$$$$$   $$$   $$                                     $$$        $$$$$$              
                     $$$                                   $$                             
                       $$$                                 $                              
                         $$                                $                              
                          $$$$$$$$                        $$                              
                                 $$                      $$                               
                                  $                     $$                                
                                  $$                   $$                                 
                                   $                  $$                                  
                                   $$                $$                                   
                                    $$              $$                                    
                                     $$           $$$                                     
                                      $          $$                                       
                                      $$        $$                                        
                                       $       $$                                         
                                       $$     $$                                          
                         $$$$$$$$$$$$$$$$$$$  $                        $$$$$$$$$$$$$$$$$$$
               $$$$      $                 $$$$                       $$                  
              $$  $$$$$$$$                   $      $$$$$        $$$$$$                   
             $$                              $$$$$$$$   $$$$$ $$$$                        
            $$                               $              $$$                           
          $$$                                $                                            
         $$                                  $                                            
        $$                                   $                                            
       $$                                   $$                                            
      $$                                    $                                             
    $$$                                     $                                             
   $$                                       $                                             
$$$$                                        $                                             
$                                           $                                             
                                            $                                             
                                            $                                             
                                            $                                             
                                            $                                             
                                            $                                             
                                            $                                             
                                            $                                             
                                            $                                             
                                           $$                                             
                                           $$                                             
                                           $$                                             
                                           $$                                             
                                           $$                                             
                                           $$                                             
                                           $                                              
